111111111111111111111111111113
144444444444444444444444444441
140000000000000000000000000641
1401110000B000000C000000000641
140001000000000000000000000041
140001000000000000000000000041
140001000000000000000000000041
140001111000000000000000000041
140000001000000000000000000041
140000001000000000000000000041
1400000011111111000000B0000041
140000001000000000000000000041
140000001111000000000000000041
140000000000000000000000000041
140010000000000000000000000041
140010000011100000000000000041
140011111110000000000006040041
140000000000000000000004460041
140000000000000000000000000041
100000000000800000000000000041
140000000000000000000000B00041
140000000000000000000000000041
140000000000000000000000000041
140000200000000B00000000000041
142000000000000000000000000041
140000000000000000000000000041
14000C00000000000B000000046441
144600000000000000000000064641
144444444444444444444444444441
311111111111111111111111111113